#####################################
#                         #       #T#
# ####### # ### # ### ### ####### # #
#       #       # #     #           #
# ### ##### ### # # # ### ##### # ###
#   # # # #   # # # #   # #   # #   #
# ### # # # ### ##### ### # ### ### #
#       #     #   #   #     # # #   #
# # ######### ####### ### ### # # # #
#             #       # #   #     # #
# # ##### # ### # # ### # ### ### # #
# # #     # # # # #     #   # # # # #
# # # ####### # ######### ### # ### #
# # # #     #   #     #     #   #   #
# # ### # ##### ##### ### ### ##### #
#     # # #     # #     # #   # # # #
# # # # # ### ### ### ### # # # # # #
# # # # #                 # # #     #
# # ####### # # ##### ### # ### #####
#       # # # #     #   #     # #   #
# ### # # ######### ########### # ###
#   # #           # #     #   # #   #
# ### ##### ######### ##### # # ### #
# #   #      #        #     #       #
# # # ##### ### # # # # #############
# # #   #     # # # #       #   # # #
# # ### ### # # # ######### ### # # #
# #   # #   # # #   # #   # # #     #
# ### ### ##### ### # # ##### # #####
#       #   #     # #     #   # #   #
# # # ##### ##### ### ### # ### # ###
# # # # # # # #     # #   # #   # # #
# #   # # # # # ######### # # # # # #
#   # # #   #                 #     #
# # # # ### ### ####### ### ### ### #
#.    #            `                #
#####################################